10 10
B . . . . . O O O .     
. . . . . . O O O .     
. . . . P O O O P .
. . . P O O O O P .
. F . O O O O P . .
. . . P O O P . . .
. . . . . . . . . .
. . . F P P . . . .
. . . F P P . . . .
. . . . F . . . . .